.....o.o..
....oo....
.....o.oo.
...o.o..o.
oo..o.....
....o....o
.....oooo.
ooo.o.....
.......o..
..o...o...
